11111111111111111111111111111
10000000000000000000000000001
10000000000010000000000000001
10000C00010010E00000000000001
10000000010010000000000000001
10000000010010000000000000001
10000000010010000000000000001
10000000010010000001100000001
10000000010010001101100000001
10000000010010001001100000001
10000000010010011101100000001
1100P011111011111101100000001
10000111110011111001100000001
10000111111011111101100000001
10000111111001111101100000001
11000011111000000000000000001
11100001111111111111100000001
11100001111111111111100000001
11100001111111111111100000001
11100001111111111111100000001
11111111111111111111100000001
11110000111111111111100000001
11110000111111111111100000001
11111111111111111111111111111
